AUUUUUUUUUUUUUUUUUUEffffkUUUUZ
LFFFFFFFFFFFFFFFFCWCWPFWKWKFFR
LFFFFFFFFFFFFFFFFxGxGGGGXGXFFR
LFFFFFFFFFFFFFFFFEHEHhHhkhkFFR
CWWKFFFFFFFFFFFFFESWdFFFWskFFR
xGGXFFFFFFFFFFFFFEHhHhHhHhkFFR
EHhyWWWWWWWKFFFFFESsSsSsSskFFR
ESsSGGGGGGGXFFFFFEHhHhHhHhkFFR
EHhHhHhHhHhkFFFFFESsSsSsSskFFR
ESsSsSsSsSskFFFFFWWWdFFWWWWFFR
WWWWWWWWdFFkFFFFFFFFFFFFFFFFFR
LFFFFFFFFFFFFFFFFFFFFFFFFFFFFR
LFFFFFFFFFFFFFFFFFFFFFFFFFFFFR
LFFFFFFFFFFFFFFFFFFFFPFFFFFFFR
LFFFFFFFFFFFFFFFFFFFFEkFFFFFFR
LFFFFFFFFFFFFCWWWWWWWYyWWWKFFR
LFFFFFFFFFFFFxGGGGGGGsSGGGXFFR
LFFFFFFFFFFFFEHhHhHhHhHhHhkFFR
LFFFFFFFFFFFFESsSsSsSsSsSskFFR
LFFFFFFFFFFFFEHhHhHhHhHhHhkFFR
QDDDDDDDDDDDDWWWWWWWWWWWWWWDDc